7 11
|---------|
|.F.|.....|
|..-|.@.P.|
|..F......|
|.--......|
|..F....-.|
|---------|