5 10
|--------|
|...|.-..|
|..-|.@..|
|......-.|
|--------|
